--------------------------------------------------------------------------------------------------------------------------------------------------------------------
--------------------------------------------------------------------------------------------------------------------------------------------------------------------
--------------------------------------------------------------------------------------------------------------------------------------------------------------------
--------------------------------------------------------------------------------------------------------------------------------------------------------------------
--------------------------------------------------------------------------------------------------------------------------------------------------------------------
---S---------------------------------------------------------------------------------------------------------------------------------######-------------------------
-######------------------------------------------------------------------------------------##########-------------------------#######-------------------------------
-----------------------------------------#############--------------#########-#############----------------------------#######--------------########--------------E-
##############-########################-#-------------##############----------------------------------################------------------------------################